###########
##....#...#
#..##.#.#.#
..#...#.#.#
##..##..#.#
#..#...#..#
#.#..##..##
#.#.#...#.#
#.#.#.##..#
#...#.....#
###########
